000000000110001030333300000000
000000001111033133330310000000
000000000111333333323111000000
222000013311330232222010212200
022222013331133322000012111220
222022133313323020000012212211
111222000131333203220011121211
211102000033333332320012112111
211110000032110333223010101120
011000000002010030222201000222
002000000022220003322020000000
002202000022200033332200000000
022222110023333003002000000000
020111110303022303300000000000
001111111030022033330000000000
001111111222022230300003333000
001111110222222323300000333000
001111111000202020000003333000
001100110000001223000000330300
000000100010003330000000333000
000000000331313011000000000000
000000003330133301200000000000
000000000333333333223200000000
000000000223333332233300000000
000000000220033332023330000300
000000012203333132333333000300
000000102220030332222303303300
000000111200000332222221303300
000202111220022202222213030330
000020111220023332222221300333
